8 10
@ @ @ @ @ @ @ @ @
@ . . @ . . . . @
@ . @ @ . . . . @
@ . . . . . . . @
@ . . . . . . . @
@ . . . . . . . @
@ . . . . . . . @
@ @ @ @ @ @ @ @ @